"filename", "language", "Python", "JSON", "XML", "comment", "blank", "total"
"c:\Users\nhlo\Documents\GitHub\NEA_Project\Stage6b\account.py", "Python", 87, 0, 0, 0, 24, 111
"c:\Users\nhlo\Documents\GitHub\NEA_Project\Stage6b\board.py", "Python", 199, 0, 0, 2, 63, 264
"c:\Users\nhlo\Documents\GitHub\NEA_Project\Stage6b\board_actions.py", "Python", 56, 0, 0, 0, 27, 83
"c:\Users\nhlo\Documents\GitHub\NEA_Project\Stage6b\database.py", "Python", 107, 0, 0, 37, 24, 168
"c:\Users\nhlo\Documents\GitHub\NEA_Project\Stage6b\difficulty_settings.py", "Python", 39, 0, 0, 0, 12, 51
"c:\Users\nhlo\Documents\GitHub\NEA_Project\Stage6b\dlx.py", "Python", 75, 0, 0, 4, 13, 92
"c:\Users\nhlo\Documents\GitHub\NEA_Project\Stage6b\game.py", "Python", 186, 0, 0, 2, 47, 235
"c:\Users\nhlo\Documents\GitHub\NEA_Project\Stage6b\game_generator.py", "Python", 27, 0, 0, 0, 9, 36
"c:\Users\nhlo\Documents\GitHub\NEA_Project\Stage6b\generator.py", "Python", 64, 0, 0, 8, 23, 95
"c:\Users\nhlo\Documents\GitHub\NEA_Project\Stage6b\gui.py", "Python", 822, 0, 0, 0, 254, 1076
"c:\Users\nhlo\Documents\GitHub\NEA_Project\Stage6b\hex_to_dec.py", "Python", 8, 0, 0, 0, 2, 10
"c:\Users\nhlo\Documents\GitHub\NEA_Project\Stage6b\options.json", "JSON", 0, 3, 0, 0, 0, 3
"c:\Users\nhlo\Documents\GitHub\NEA_Project\Stage6b\pyqt_widgets.py", "Python", 250, 0, 0, 5, 65, 320
"c:\Users\nhlo\Documents\GitHub\NEA_Project\Stage6b\rating_calc.py", "Python", 140, 0, 0, 3, 14, 157
"c:\Users\nhlo\Documents\GitHub\NEA_Project\Stage6b\resources\account.svg", "XML", 0, 0, 8, 0, 1, 9
"c:\Users\nhlo\Documents\GitHub\NEA_Project\Stage6b\resources\back.svg", "XML", 0, 0, 128, 0, 1, 129
"c:\Users\nhlo\Documents\GitHub\NEA_Project\Stage6b\resources\delete.svg", "XML", 0, 0, 180, 0, 1, 181
"c:\Users\nhlo\Documents\GitHub\NEA_Project\Stage6b\resources\exit.svg", "XML", 0, 0, 13, 0, 1, 14
"c:\Users\nhlo\Documents\GitHub\NEA_Project\Stage6b\resources\help.svg", "XML", 0, 0, 145, 0, 1, 146
"c:\Users\nhlo\Documents\GitHub\NEA_Project\Stage6b\resources\hint.svg", "XML", 0, 0, 90, 0, 1, 91
"c:\Users\nhlo\Documents\GitHub\NEA_Project\Stage6b\resources\info.svg", "XML", 0, 0, 72, 0, 1, 73
"c:\Users\nhlo\Documents\GitHub\NEA_Project\Stage6b\resources\notes_off.svg", "XML", 0, 0, 91, 0, 1, 92
"c:\Users\nhlo\Documents\GitHub\NEA_Project\Stage6b\resources\notes_on.svg", "XML", 0, 0, 63, 0, 1, 64
"c:\Users\nhlo\Documents\GitHub\NEA_Project\Stage6b\resources\resign.svg", "XML", 0, 0, 65, 0, 1, 66
"c:\Users\nhlo\Documents\GitHub\NEA_Project\Stage6b\resources\settings.svg", "XML", 0, 0, 11, 0, 1, 12
"c:\Users\nhlo\Documents\GitHub\NEA_Project\Stage6b\resources\stats.svg", "XML", 0, 0, 20, 0, 1, 21
"c:\Users\nhlo\Documents\GitHub\NEA_Project\Stage6b\resources\undo.svg", "XML", 0, 0, 110, 0, 1, 111
"c:\Users\nhlo\Documents\GitHub\NEA_Project\Stage6b\solver.py", "Python", 57, 0, 0, 1, 17, 75
"c:\Users\nhlo\Documents\GitHub\NEA_Project\Stage6b\stack.py", "Python", 17, 0, 0, 0, 4, 21
"c:\Users\nhlo\Documents\GitHub\NEA_Project\Stage6b\sudoku.py", "Python", 20, 0, 0, 4, 7, 31
"c:\Users\nhlo\Documents\GitHub\NEA_Project\Stage6b\terminal.py", "Python", 173, 0, 0, 2, 22, 197
"c:\Users\nhlo\Documents\GitHub\NEA_Project\Stage6b\ui.py", "Python", 16, 0, 0, 0, 7, 23
"Total", "-", 2343, 3, 996, 68, 647, 4057